..X..X..X..X..
B.............
.............L
B.............
..............
.............C
..............
D.............
..............
.............C
.......F......
